##### ##########
#        #     #
         #      
#        #     #
#        #     #
!              !
#           #  #
#    ##     #  #
#    #      #  #
#    #      #  #
#    #  #   #  #
## #############